128 30
0 0 0 0 0 0 0 0 0 0 0 0 0 0 0 0 0 0 0 0 0 0 0 0 0 0 0 0 0 0 0 0 0 0 0 0 0 0 0 0 0 0 0 0 0 0 0 0 0 0 0 0 0 0 0 0 0 0 0 0 0 0 0 0 0 0 0 0 0 0 0 0 0 0 0 0 0 0 0 0 0 0 0 0 0 0 0 0 0 0 0 0 0 0 0 0 0 0 0 0 0 0 0 0 0 0 0 0 0 0 0 0 0 0 0 0 0 0 0 0 0 0 0 0 0 0 0 0
0 0 0 0 0 0 0 0 0 0 0 0 0 0 0 0 0 0 0 0 0 0 0 0 0 0 0 0 0 0 0 0 0 0 0 0 0 0 0 0 0 0 0 0 0 0 0 0 0 0 0 0 0 0 0 0 0 0 0 0 0 0 0 0 0 0 0 0 0 0 0 0 0 0 0 0 0 0 0 0 0 0 0 0 0 0 0 0 0 0 0 0 0 0 0 0 0 0 0 0 0 0 0 0 0 0 0 0 0 0 0 0 0 0 0 0 0 0 0 0 0 0 0 0 0 0 0 0
0 0 0 0 0 0 1 0 1 0 0 0 0 0 0 0 0 0 0 0 0 0 0 0 0 0 0 0 0 0 0 0 0 0 0 0 0 0 1 0 1 0 0 0 0 0 0 0 0 0 0 0 0 0 1 0 1 0 0 0 0 0 0 0 0 0 0 0 0 0 1 0 1 0 0 0 0 0 0 0 0 0 0 0 0 0 1 0 1 0 0 0 0 0 0 0 0 0 0 0 0 0 1 0 1 0 0 0 0 0 0 0 0 0 0 0 0 0 0 0 0 0 0 0 0 0 0 0
0 0 0 0 0 0 2 3 3 0 0 0 0 0 0 0 0 0 0 0 0 0 4 5 5 0 0 0 0 0 0 0 0 0 0 0 0 0 2 3 3 0 0 0 0 0 0 0 0 0 0 0 0 0 2 3 3 0 0 0 0 0 0 0 0 0 0 0 0 0 2 3 3 0 0 0 0 0 0 0 0 0 0 0 0 0 2 3 3 0 0 0 0 0 0 0 0 0 0 0 0 0 2 3 3 0 0 0 0 0 0 0 0 0 0 0 0 0 0 0 0 0 0 0 0 0 0 0
0 0 0 0 0 0 6 7 7 0 0 0 0 0 0 0 0 0 0 0 0 0 6 7 7 0 0 0 0 0 0 0 0 0 0 0 0 0 6 7 7 0 0 0 0 0 0 0 0 0 0 0 0 0 6 7 7 0 0 0 0 0 0 0 0 0 0 0 0 0 6 7 7 0 0 0 0 0 0 0 0 0 0 0 0 0 6 7 7 0 0 0 0 0 0 0 0 0 0 0 0 0 6 7 7 0 0 0 0 0 0 0 0 0 0 0 0 0 0 0 0 0 0 0 0 0 0 0
0 0 0 0 0 0 6 7 7 0 0 0 0 0 0 0 0 0 0 0 0 0 6 7 7 0 0 0 0 0 0 0 0 0 0 0 0 0 6 7 7 0 0 0 0 0 0 0 0 0 0 0 0 0 6 7 7 0 0 0 0 0 0 0 0 0 0 0 0 0 6 7 7 0 0 0 0 0 0 0 0 0 0 0 0 0 6 7 7 0 0 0 0 0 0 0 0 0 0 0 0 0 6 7 7 0 0 0 0 0 0 0 0 0 0 0 0 0 0 0 0 0 0 0 0 0 0 0
0 0 0 0 1 0 6 7 7 0 0 0 0 0 0 0 0 0 0 0 1 0 6 7 7 0 0 0 0 0 0 0 0 0 0 0 1 0 6 7 7 0 0 0 0 0 0 0 0 0 0 0 1 0 6 7 7 0 0 0 0 0 0 0 0 0 0 0 1 0 6 7 7 0 0 0 0 0 0 0 0 0 0 0 1 0 6 7 7 0 0 0 0 0 0 0 0 0 0 0 1 0 6 7 7 0 0 0 0 0 0 0 0 0 0 0 0 0 0 0 0 0 0 0 0 0 0 0
0 0 0 0 8 9 9 7 7 0 0 0 1 0 0 0 0 0 0 0 8 9 9 7 7 0 0 0 1 0 0 0 0 0 0 0 8 9 9 7 7 0 0 0 1 0 0 0 0 0 0 0 8 9 9 7 7 0 0 0 1 0 0 0 0 0 0 0 8 9 9 7 7 0 0 0 1 0 0 0 0 0 0 0 8 9 9 7 7 0 0 0 1 0 0 0 0 0 0 0 8 9 9 7 7 0 0 0 1 0 0 0 0 0 0 0 0 0 0 0 0 0 0 0 0 0 0 0
0 0 0 0 10 11 11 7 7 0 0 0 2 3 0 0 0 0 0 0 10 11 11 7 7 0 0 0 2 3 0 0 0 0 0 0 10 11 11 7 7 0 0 0 2 3 0 0 0 0 0 0 10 11 11 7 7 0 0 0 2 3 0 0 0 0 0 0 10 11 11 7 7 0 0 0 2 3 0 0 0 0 0 0 10 11 11 7 7 0 0 0 2 3 0 0 0 0 0 0 10 11 11 7 7 0 0 0 2 3 0 0 0 0 0 0 0 0 0 0 0 0 0 0 0 0 0 0
0 0 0 0 10 11 11 7 7 1 0 0 6 7 1 0 0 0 0 0 10 11 11 7 7 1 0 0 6 7 1 0 0 0 0 0 10 11 11 7 7 1 0 0 6 7 1 0 0 0 0 0 10 11 11 7 7 1 0 0 6 7 1 0 0 0 0 0 10 11 11 7 7 1 0 0 6 7 1 0 0 0 0 0 10 11 11 7 7 1 0 0 6 7 1 0 0 0 0 0 10 11 11 7 7 1 0 0 6 7 1 0 0 0 0 0 0 0 0 0 0 0 0 0 0 0 0 0
0 0 0 0 10 11 11 7 8 9 0 1 6 8 9 0 0 0 0 0 10 11 11 7 8 9 0 1 6 8 9 0 0 0 0 0 10 11 11 7 8 9 0 1 6 8 9 0 0 0 0 0 10 11 11 7 8 9 0 1 6 8 9 0 0 0 0 0 10 11 11 7 8 9 0 1 6 8 9 0 0 0 0 0 10 11 11 7 8 9 0 1 6 8 9 0 0 0 0 0 10 11 11 7 8 9 0 1 6 8 9 0 0 0 0 0 0 0 0 0 0 0 0 0 0 0 0 0
0 0 0 0 10 11 11 7 10 11 0 2 6 10 11 0 0 0 0 0 10 11 11 7 10 11 0 2 6 10 11 0 0 0 0 0 10 11 11 7 10 11 0 2 6 10 11 0 0 0 0 0 10 11 11 7 10 11 0 2 6 10 11 0 0 0 0 0 10 11 11 7 10 11 0 2 6 10 11 0 0 0 0 0 10 11 11 7 10 11 0 2 6 10 11 0 0 0 0 0 10 11 11 7 10 11 0 2 6 10 11 0 0 0 0 0 0 0 0 0 0 0 0 0 0 0 0 0
0 0 12 13 13 13 13 13 13 13 13 13 13 13 13 14 0 0 12 13 13 13 13 13 13 13 13 13 13 13 13 14 0 0 12 13 13 13 13 13 13 13 13 13 13 13 13 14 0 0 12 13 13 13 13 13 13 13 13 13 13 13 13 14 0 0 12 13 13 13 13 13 13 13 13 13 13 13 13 14 0 0 12 13 13 13 13 13 13 13 13 13 13 13 13 14 0 0 12 13 13 13 13 13 13 13 13 13 13 13 13 14 0 0 0 0 0 0 0 0 0 0 0 0 0 0 0 0
0 0 15 16 16 16 16 16 16 16 16 16 16 16 16 16 0 0 15 16 16 16 16 16 16 16 16 16 16 16 16 16 0 0 15 16 16 16 16 16 16 16 16 16 16 16 16 16 0 0 15 16 16 16 16 16 16 16 16 16 16 16 16 16 0 0 15 16 16 16 16 16 16 16 16 16 16 16 16 16 0 0 15 16 16 16 16 16 16 16 16 16 16 16 16 16 0 0 15 16 16 16 16 16 16 16 16 16 16 16 16 16 0 0 0 0 0 0 0 0 0 0 0 0 0 0 0 0
0 0 15 17 17 17 17 17 17 17 17 17 17 17 17 17 0 0 15 17 17 17 17 17 17 17 17 17 17 17 17 17 0 0 15 17 17 17 17 17 17 17 17 17 17 17 17 17 0 0 15 17 17 17 17 17 17 17 17 17 17 17 17 17 0 0 15 17 17 17 17 17 17 17 17 17 17 17 17 17 0 0 15 17 17 17 17 17 17 17 17 17 17 17 17 17 0 0 15 17 17 17 17 17 17 17 17 17 17 17 17 17 0 0 0 0 0 0 0 0 0 0 0 0 0 0 0 0
0 0 15 16 16 16 16 16 16 16 16 16 16 16 16 16 0 0 15 18 18 18 18 18 18 18 18 18 18 18 18 18 0 0 15 19 19 19 19 19 19 19 19 19 19 19 19 19 0 0 15 19 19 19 19 19 19 19 19 19 19 19 19 19 0 0 15 18 18 18 18 18 18 18 18 18 18 18 18 18 0 0 15 16 16 16 16 16 16 16 16 16 16 16 16 16 0 0 15 18 18 18 18 18 18 18 18 18 18 18 18 18 0 0 1 1 0 0 0 0 0 0 0 0 1 1 0 0
0 0 15 17 20 17 20 17 20 17 17 21 22 21 22 17 0 0 15 23 23 21 22 23 21 22 23 21 22 23 20 24 0 0 15 25 25 20 25 25 25 25 20 25 20 25 20 25 0 0 15 25 25 20 25 25 25 25 20 25 20 25 20 25 0 0 15 23 23 21 22 23 21 22 23 21 22 23 20 24 0 0 15 17 20 17 20 17 20 17 17 21 22 21 22 17 0 0 15 23 23 21 22 23 21 22 23 21 22 23 20 24 0 0 8 9 0 0 0 1 0 0 0 2 8 9 0 0
0 0 15 17 26 17 26 17 26 17 17 27 28 27 28 17 0 0 15 23 23 29 30 23 29 30 23 29 30 23 31 24 0 32 15 25 25 31 25 33 14 25 31 25 31 25 31 25 0 1 15 25 25 31 25 33 14 25 31 25 31 25 31 25 0 0 15 23 23 29 30 23 29 30 23 29 30 23 31 24 0 0 15 17 26 17 26 17 26 17 17 27 28 27 28 17 0 0 15 23 23 29 30 23 29 30 23 29 30 23 31 24 0 0 10 11 0 0 1 2 3 1 0 6 10 11 1 0
0 0 15 17 31 17 31 17 31 17 17 29 30 29 30 17 0 0 15 23 23 18 18 23 18 18 23 18 18 23 18 24 0 8 34 25 25 19 25 19 19 25 19 25 19 25 19 25 0 8 34 25 25 19 25 19 19 25 19 25 19 25 19 25 0 0 15 23 23 18 18 23 18 18 23 18 18 23 18 24 0 0 15 17 31 17 31 17 31 17 17 29 30 29 30 17 0 0 15 23 23 18 18 23 18 18 23 18 18 23 18 24 0 0 10 11 0 0 8 9 7 8 0 6 2 3 3 0
0 0 34 33 13 14 16 17 16 17 17 16 16 16 16 17 1 1 34 35 35 35 35 35 35 35 35 35 35 35 35 35 0 10 36 35 35 35 35 35 35 35 35 35 35 35 35 35 0 10 36 35 35 35 35 35 35 35 35 35 35 35 35 35 1 1 34 35 35 35 35 35 35 35 35 35 35 35 35 35 0 0 34 33 13 14 16 17 16 17 17 16 16 16 16 17 1 1 34 35 35 35 35 35 35 35 35 35 35 35 35 35 37 37 37 37 37 37 37 37 37 37 37 37 37 37 37 37
0 0 36 35 35 35 35 35 35 35 35 35 35 35 35 35 2 3 36 18 18 18 38 39 40 18 18 18 18 18 18 18 0 10 41 19 19 19 19 19 19 19 19 19 19 19 19 19 0 10 36 19 19 19 19 19 19 19 19 19 19 19 19 19 2 3 36 18 18 18 38 39 40 18 18 18 18 18 18 18 0 0 36 35 35 35 35 35 35 35 35 35 35 35 35 35 2 3 36 18 18 18 38 39 40 18 18 18 18 18 18 18 42 43 42 43 42 43 42 43 42 43 42 43 42 43 42 43
0 0 36 16 16 16 16 16 16 16 16 16 16 16 16 16 6 7 36 23 20 23 21 44 22 23 20 23 20 23 20 24 0 10 36 25 25 25 25 25 25 25 25 25 25 25 25 25 0 10 36 25 25 25 25 25 25 25 25 25 25 25 25 25 6 7 36 23 20 23 21 44 22 23 20 23 20 23 20 24 0 0 36 16 16 16 16 16 16 16 16 16 16 16 16 16 6 7 36 23 20 23 21 44 22 23 20 23 20 23 20 24 43 42 43 42 43 42 43 42 43 42 43 42 43 42 42 45
0 0 36 17 20 17 20 17 20 17 17 21 22 21 22 17 6 7 36 23 26 23 27 46 28 23 26 23 26 23 26 24 0 10 36 25 33 14 25 25 20 25 33 47 48 25 20 25 0 10 36 25 33 14 25 25 20 25 33 47 48 25 20 25 6 7 36 23 26 23 27 46 28 23 26 23 26 23 26 24 0 0 36 17 20 17 20 17 20 17 17 21 22 21 22 17 6 7 36 23 26 23 27 46 28 23 26 23 26 23 26 24 35 35 35 35 35 35 35 35 35 35 35 35 35 35 42 43
0 0 36 17 26 17 26 17 26 17 17 27 28 27 28 17 6 8 36 23 31 23 27 46 28 23 31 23 31 23 31 24 2 10 36 25 19 19 25 25 31 25 21 44 22 25 31 25 2 10 36 25 19 19 25 25 31 25 21 44 22 25 31 25 6 8 36 23 31 23 27 46 28 23 31 23 31 23 31 24 0 0 36 17 26 17 26 17 26 17 17 27 28 27 28 17 6 8 36 23 31 23 27 46 28 23 31 23 31 23 31 24 49 50 49 50 49 50 49 50 49 50 49 50 49 50 42 45
51 51 36 17 31 17 31 17 31 17 17 29 30 29 30 17 6 10 36 23 19 23 29 35 30 52 18 23 18 23 18 24 6 10 36 25 25 25 25 25 19 25 27 46 28 25 19 25 6 10 36 25 25 25 25 25 19 25 27 46 28 25 19 25 6 10 36 23 53 23 29 35 30 23 18 23 18 23 18 24 51 51 36 17 31 17 31 17 31 17 17 29 30 29 30 17 6 10 36 23 53 23 29 35 30 23 18 23 18 23 18 24 49 49 49 49 49 49 49 49 49 49 49 49 49 49 42 43
49 49 36 17 16 17 16 17 16 17 17 16 16 16 16 17 6 10 36 54 54 54 55 56 57 54 54 54 54 54 54 54 6 10 36 54 54 54 54 54 54 54 29 35 30 54 54 58 6 10 36 54 54 54 54 54 54 54 29 35 30 54 54 54 6 10 36 54 54 54 59 56 60 54 54 54 54 54 54 54 49 49 36 17 16 17 16 17 16 17 17 16 16 16 16 17 6 10 36 54 54 54 59 56 60 54 54 54 54 54 54 54 49 49 49 49 49 50 49 50 49 50 49 50 49 50 42 45
61 61 62 61 61 61 61 61 61 61 61 61 61 61 61 61 61 61 62 63 63 63 56 56 64 63 63 63 63 63 63 63 61 61 62 63 63 63 63 63 63 63 59 56 60 63 63 63 61 61 62 63 63 63 63 63 63 63 59 56 60 63 63 63 61 61 62 63 63 63 59 56 60 63 63 63 63 63 63 63 61 61 62 61 61 61 61 61 61 61 61 61 61 61 61 61 61 61 62 63 63 63 59 56 60 63 63 63 63 63 63 63 37 37 37 45 65 65 65 65 65 65 65 65 65 65 42 43
66 66 66 66 66 67 68 69 68 69 70 66 66 66 66 66 66 66 66 66 66 66 66 66 66 66 66 66 66 66 66 66 66 66 66 66 66 66 66 66 66 66 66 66 66 66 66 66 66 66 66 66 66 66 66 66 66 66 66 66 66 66 66 66 66 66 66 66 66 66 66 66 66 66 66 66 66 66 66 66 66 66 66 66 66 67 68 69 68 69 70 66 66 66 66 66 66 66 66 66 66 66 66 66 66 66 66 66 66 66 66 66 42 43 42 43 71 37 45 37 37 37 37 37 37 37 42 43
72 72 72 72 72 72 72 72 72 72 72 72 72 72 72 72 72 72 72 72 72 72 72 72 72 72 72 72 72 72 72 72 72 72 72 72 72 72 72 72 72 72 72 72 72 72 72 72 72 72 72 72 72 72 72 72 72 72 72 72 72 72 72 72 72 72 72 72 72 72 72 72 72 72 72 72 72 72 72 72 72 72 72 72 72 72 72 72 72 72 72 72 72 72 72 72 72 72 72 72 72 72 72 72 72 72 72 72 72 72 72 72 43 43 73 74 43 42 43 42 43 42 43 42 43 42 42 43
75 75 75 75 75 75 75 75 75 75 75 75 75 75 75 75 75 75 75 75 75 75 75 75 75 75 75 75 75 75 75 75 75 75 75 75 75 75 75 75 75 75 75 75 75 75 75 75 75 75 75 75 75 75 75 75 75 75 75 75 75 75 75 75 75 75 75 75 75 75 75 75 75 75 75 75 75 75 75 75 75 75 75 75 75 75 75 75 75 75 75 75 75 75 75 75 75 75 75 75 75 75 75 75 75 75 75 75 75 75 75 75 42 43 42 43 42 43 42 43 42 43 42 43 42 43 43 42
25
1 0 480 16 480
1 2032 480 16 304
1 1792 64 64 64
1 2016 128 32 80
1 1792 176 256 48
1 1856 48 192 48
2 0 32 1792 8
0 0 48 96 8
0 48 176 48 8
0 32 288 224 8
0 288 288 224 8
0 160 48 1216 8
0 544 288 224 8
0 576 128 32 8
0 624 208 32 8
0 672 128 48 8
0 832 128 32 8
0 880 208 32 8
0 928 128 48 8
0 800 288 224 8
0 1056 288 224 8
0 1328 176 48 8
0 1312 288 224 8
0 1440 48 352 8
0 1568 288 224 8