16 14
86 86 87 86 86 86 87 86 86 86 87 86 86 86 87 86
49 49 49 49 49 49 49 49 49 49 49 49 49 49 49 49
49 49 49 49 49 49 49 49 49 49 49 49 49 49 49 49
49 49 49 49 49 49 49 49 49 49 49 49 49 49 49 49
49 49 49 49 49 88 49 49 49 49 49 49 49 49 49 49
49 49 49 49 49 49 49 49 49 49 49 49 49 49 49 49
49 49 49 89 90 91 49 49 49 49 49 88 49 49 49 49
49 49 49 49 49 49 49 49 49 49 49 49 49 49 49 49
49 88 49 49 49 49 49 49 49 49 49 49 49 49 49 49
49 49 49 49 49 49 49 49 49 49 49 49 49 49 49 49
49 49 49 49 49 49 49 49 49 49 49 49 49 49 49 49
49 49 49 49 49 49 49 49 49 49 49 49 49 49 49 49
92 92 92 92 92 92 92 92 92 92 92 92 92 92 92 92
49 49 49 49 49 49 49 49 49 49 49 49 49 49 49 49
8
1 0 224 16 224
1 240 224 16 224
1 0 224 256 16
1 0 32 256 16
0 48 128 48 8
4 80 160 16 16
4 176 128 16 16
4 16 96 16 16