15
17 300 155 1 400 155 0
17 600 150 2 400 155 1
17 50 100 0 300 144 0
8 136 104 16 3 6 6 6 6 6 6 6 6 6 6 6 6 6 6 6
8 72 200 30 3 6 6 6 6 6 6 6 6 6 6 6 6 6 6 6 6 6 6 6 6 6 6 6 6 6 6 6 6 6
8 328 88 28 3 6 6 6 6 6 6 6 6 6 6 6 6 6 6 6 6 6 6 6 6 6 6 6 6 6 6 6
8 424 184 16 4 6 6 6 6 6 6 6 6 6 6 6 6 6 6 6
8 584 152 28 0 6 6 6 6 6 6 6 6 6 6 6 6 6 6 6 6 6 6 6 6 6 6 6 6 6 6 6
8 840 152 1 4
8 1096 88 1 5
8 1192 184 1 3
8 1352 200 1 3
8 1416 104 1 4
8 1608 88 1 3
8 1704 184 1 7