64 59
93 94 94 94 94 94 94 94 93 94 94 94 94 94 94 94 93 94 94 94 95 96 95 96 93 94 94 94 94 94 94 94 93 94 94 94 94 94 94 94 93 94 94 94 94 94 94 94 93 94 94 94 94 94 94 94 93 94 94 94 94 94 94 94
97 98 98 98 98 99 100 98 97 100 98 98 98 98 99 101 97 98 98 98 102 103 102 103 97 100 98 98 99 100 99 104 97 98 98 98 105 106 104 107 97 100 98 98 98 98 99 101 97 98 98 98 98 99 100 98 97 100 98 98 98 98 99 101
97 100 108 108 99 106 106 100 109 106 100 99 100 99 106 106 109 110 108 108 111 112 111 112 109 106 100 99 106 106 106 106 109 100 108 108 99 106 107 108 109 106 100 99 100 99 106 106 97 100 108 108 99 106 106 100 109 106 100 99 100 99 106 106
109 106 100 99 106 106 106 106 109 106 106 106 106 106 106 106 109 113 100 99 102 103 102 103 109 106 106 106 106 106 106 106 109 106 100 99 106 106 114 108 97 106 106 106 106 106 106 106 109 106 100 99 106 106 106 106 109 106 106 106 106 106 106 106
109 106 106 106 106 115 116 117 109 106 106 106 106 106 106 106 109 106 115 116 118 119 118 119 97 106 106 106 106 120 121 106 97 106 106 106 106 106 106 100 109 106 106 106 106 106 106 106 109 106 106 106 106 115 116 117 109 106 106 106 106 106 106 106
109 122 123 122 123 124 125 126 97 122 123 123 123 123 123 122 97 106 113 113 113 113 113 113 97 106 106 106 106 113 113 106 97 122 123 123 123 122 123 123 97 122 123 123 123 123 122 123 109 122 123 122 123 124 125 126 97 122 123 123 123 123 123 122
97 106 101 101 104 100 98 98 97 104 120 127 127 121 101 107 97 122 123 123 123 123 122 123 97 122 123 123 123 122 123 123 115 128 116 116 117 116 116 117 97 104 129 130 129 130 101 107 97 106 101 101 104 100 98 98 97 104 120 127 127 121 101 107
97 106 106 106 106 106 100 99 97 106 113 113 113 113 107 108 109 104 101 101 101 101 104 104 109 101 104 101 101 101 107 108 131 113 113 113 113 113 113 113 97 106 113 113 113 113 107 108 97 106 106 106 106 106 100 99 97 106 113 113 113 113 107 108
109 106 106 106 106 106 106 107 97 106 106 106 106 106 132 108 109 106 106 106 106 106 106 106 109 106 106 106 106 106 100 108 109 106 106 133 134 106 106 107 97 106 106 106 106 106 100 108 109 106 106 106 106 106 106 107 97 106 106 106 106 106 100 108
93 106 106 106 106 106 106 100 109 106 106 106 106 106 106 100 95 96 95 96 106 106 106 95 96 106 106 95 96 106 106 100 93 106 106 135 136 106 106 100 93 106 106 106 106 106 106 100 93 106 106 106 106 106 106 100 109 106 106 106 106 106 106 100
93 122 123 123 123 123 122 123 97 123 123 123 123 123 122 123 102 103 102 103 137 137 122 138 103 122 123 102 103 122 123 123 93 122 123 139 140 123 122 123 93 122 123 122 123 123 122 123 93 122 123 123 123 123 122 123 97 123 123 123 123 123 122 123
115 128 116 117 101 101 106 104 97 101 104 101 106 115 128 117 118 119 118 119 116 116 116 118 119 116 116 118 119 116 116 117 115 116 141 116 116 141 116 116 128 116 116 116 128 116 116 117 115 128 116 117 101 101 106 104 97 101 104 101 106 115 128 117
142 143 143 144 129 130 106 106 93 106 106 129 130 142 143 144 142 143 143 143 143 143 143 143 143 143 143 143 143 143 143 144 142 143 143 143 143 143 143 143 143 143 143 143 143 143 143 144 142 143 143 144 129 130 106 106 93 106 106 129 130 142 143 144
124 125 125 126 113 113 106 106 93 106 106 113 113 124 125 126 124 125 125 125 125 125 125 125 125 125 125 125 125 125 125 126 124 125 125 125 125 125 125 125 125 125 125 125 125 125 125 126 124 125 125 126 113 113 106 106 93 106 106 113 113 124 125 126
93 145 145 145 145 145 145 145 93 145 145 145 145 145 145 145 115 116 116 128 116 116 116 116 128 116 116 116 116 128 116 117 93 145 145 145 145 145 145 145 93 145 145 145 145 145 145 145 93 145 145 145 145 145 145 145 93 145 145 145 145 145 145 145
93 94 94 94 94 94 94 94 93 94 94 94 94 94 94 94 142 143 143 143 143 143 143 143 143 143 143 143 143 143 143 146 93 94 94 94 94 94 94 94 93 94 94 94 94 94 94 94 93 94 94 94 94 94 94 94 93 94 94 94 94 94 94 94
97 98 98 98 98 98 98 98 97 100 98 98 98 98 99 106 147 148 148 148 148 148 148 148 148 148 148 148 148 148 148 149 97 98 98 98 98 98 98 98 97 100 98 98 98 98 99 106 97 99 100 98 98 98 98 98 97 100 98 98 98 98 99 104
97 100 108 108 99 100 108 108 97 106 100 99 100 99 106 106 147 148 148 148 148 148 148 148 148 148 148 148 148 148 148 149 97 100 108 108 99 100 108 108 97 106 100 99 100 99 106 106 109 106 106 100 99 100 108 108 109 106 100 99 100 99 106 106
109 106 100 99 106 106 100 108 109 106 106 106 106 106 106 106 142 143 143 143 143 143 143 143 143 143 143 143 143 143 143 144 109 106 100 99 106 106 100 108 109 106 106 106 106 106 106 106 109 106 106 106 106 106 129 130 129 130 106 106 106 106 106 106
109 106 106 106 106 106 106 100 109 106 106 106 106 106 106 106 147 148 148 148 148 148 148 148 148 148 148 148 148 148 148 149 109 106 106 106 106 106 106 100 97 106 106 106 106 106 106 106 97 106 106 106 106 106 113 113 109 113 106 106 106 106 106 106
109 123 123 123 122 123 123 123 150 123 123 123 123 123 122 123 147 148 148 148 148 148 148 148 148 148 148 148 148 148 148 149 109 123 123 123 122 123 123 123 97 123 123 123 123 123 122 123 97 122 123 123 122 123 122 123 109 122 122 123 123 122 123 122
97 106 101 101 106 106 101 100 97 106 101 104 106 101 106 107 147 148 148 148 148 148 148 148 148 148 148 148 148 148 148 149 97 106 101 101 106 106 101 100 97 106 101 104 106 101 106 107 97 151 152 153 101 104 101 100 109 104 101 104 151 152 153 101
97 106 106 106 106 106 106 106 97 106 106 106 106 106 107 108 147 148 148 148 148 148 148 148 148 148 148 148 148 148 148 149 97 106 106 106 106 106 106 106 97 106 106 106 106 106 107 108 97 113 113 113 106 120 121 106 109 120 121 106 113 113 113 106
109 106 106 106 106 106 106 107 109 106 106 106 106 106 100 108 147 148 148 148 148 148 148 148 148 148 148 148 148 148 148 149 109 106 106 106 106 106 106 107 109 106 106 106 106 106 100 108 109 106 106 106 106 113 113 106 97 113 113 106 106 106 106 106
97 106 106 106 106 106 106 100 109 106 106 106 106 106 106 100 142 143 143 143 143 143 143 143 143 143 143 143 143 143 143 144 97 106 106 106 106 106 106 100 109 106 106 106 106 106 106 100 93 106 106 106 106 106 106 106 109 106 106 106 106 106 106 106
97 122 123 123 123 122 123 123 97 123 123 123 123 122 123 123 147 148 148 148 148 148 148 148 148 148 148 148 148 148 148 149 97 122 123 123 123 122 123 123 97 123 123 123 123 122 123 123 93 123 123 123 123 123 123 123 93 123 123 123 123 123 123 122
109 99 101 106 104 106 106 106 97 104 101 106 106 106 106 100 147 148 148 148 148 148 148 148 148 148 148 148 148 148 148 149 109 99 101 106 104 106 106 106 154 155 101 106 106 106 106 100 115 156 157 157 157 157 157 157 157 157 157 157 157 157 158 117
93 106 106 106 106 106 106 106 93 106 106 106 106 106 106 106 147 148 148 148 148 148 148 148 148 148 148 148 148 148 148 149 93 106 106 106 106 106 106 106 93 106 106 106 106 106 106 106 142 143 143 143 144 143 143 143 143 142 143 143 143 143 143 144
93 106 106 106 106 106 106 106 93 106 106 106 106 106 106 106 124 125 125 125 125 125 125 125 125 125 125 125 125 125 125 126 93 106 106 106 106 106 106 106 93 106 106 106 106 106 106 106 124 125 125 125 126 125 125 125 125 124 125 125 125 125 125 126
115 116 116 128 145 145 145 145 93 145 145 145 145 145 145 145 93 145 145 145 145 145 145 145 93 145 145 145 145 145 145 145 93 145 145 145 145 145 145 145 93 145 145 145 145 145 145 145 93 145 145 145 145 145 145 145 93 145 145 145 145 145 145 145
142 143 143 144 94 94 94 94 93 94 94 94 94 94 94 94 93 94 94 94 94 94 94 94 93 94 94 94 94 94 94 94 93 94 94 94 94 94 94 94 93 94 94 94 94 94 94 94 93 94 94 94 94 94 94 94 93 94 94 94 94 94 94 94
147 148 148 149 98 98 98 98 97 100 98 98 98 105 106 104 97 98 98 98 98 98 98 98 97 100 98 98 98 98 99 106 97 98 98 98 98 98 98 98 97 100 98 98 98 98 99 106 97 98 98 98 98 98 98 98 97 98 99 100 98 98 99 104
147 148 148 149 120 127 127 127 127 121 100 99 100 99 106 106 109 100 108 108 99 100 108 99 109 106 100 99 100 99 106 106 97 100 108 108 99 100 108 108 97 106 100 99 100 99 106 106 109 100 108 108 99 100 108 108 109 99 106 106 100 99 106 106
142 143 143 144 113 113 113 113 131 113 106 106 106 106 106 106 109 106 100 99 106 129 130 106 109 106 106 106 106 106 106 106 109 106 100 99 106 106 100 108 97 106 106 106 106 106 106 106 109 106 100 99 106 106 100 99 109 106 106 106 106 106 106 106
147 148 148 149 106 106 106 107 97 106 106 106 106 106 115 117 97 106 106 106 106 113 113 106 97 123 115 117 122 123 123 123 109 106 106 106 106 106 106 100 97 106 106 106 106 106 106 106 109 122 115 117 122 123 123 115 117 122 123 122 115 117 122 123
147 148 148 149 122 123 107 108 97 122 123 122 123 122 142 144 93 104 101 104 101 101 104 101 109 104 142 144 101 104 104 101 109 123 123 123 122 123 123 123 97 123 123 123 123 123 122 123 97 101 142 144 104 101 104 142 144 101 104 101 142 144 101 104
124 125 125 126 104 106 101 104 97 104 120 127 127 121 124 126 115 116 117 122 122 122 122 122 109 122 124 125 115 116 116 117 97 106 101 101 106 106 101 100 97 106 101 104 106 101 106 107 115 128 124 126 115 116 117 124 126 115 116 117 124 126 116 117
131 113 113 113 106 120 121 106 109 106 113 113 113 113 113 113 142 143 144 101 104 101 104 107 97 101 113 113 113 113 113 113 97 106 106 106 106 106 106 106 97 106 106 106 106 106 107 108 131 113 113 113 113 113 113 113 131 113 113 113 113 113 113 113
97 106 106 106 106 113 113 107 109 106 106 106 106 106 106 107 147 148 149 122 107 105 107 159 109 105 122 122 123 122 123 122 109 106 106 106 106 106 106 107 109 106 106 106 106 106 100 108 109 106 106 160 161 106 106 107 109 105 107 105 106 106 106 106
109 106 106 106 106 106 106 100 97 106 106 106 106 106 107 108 147 148 149 107 108 108 159 49 109 99 101 104 106 106 101 107 97 106 106 106 106 106 106 100 109 106 106 106 106 106 106 100 93 106 106 162 163 106 106 100 93 108 108 108 105 106 106 106
97 122 123 123 122 122 123 123 97 122 122 123 122 107 108 108 147 148 149 108 108 159 49 49 93 122 123 122 122 122 107 159 97 122 123 123 123 122 123 123 97 123 123 123 123 122 123 123 93 122 123 164 165 123 122 123 93 108 108 108 108 105 123 122
115 117 104 101 104 101 106 104 109 104 101 106 104 101 104 115 147 148 149 115 116 128 116 166 167 116 128 116 116 166 167 117 109 99 101 106 104 106 106 106 97 104 101 106 106 106 106 100 115 116 141 116 116 141 116 116 128 116 116 116 116 128 116 117
142 143 115 117 106 106 106 106 93 106 106 106 106 115 117 144 142 143 143 143 143 143 143 143 143 143 143 143 143 143 143 144 93 106 106 106 106 106 106 106 93 106 106 106 106 106 106 106 142 143 143 143 143 143 143 143 143 143 143 143 143 143 143 144
124 125 125 126 106 106 106 106 93 106 106 106 106 124 125 126 124 125 125 125 125 125 125 125 125 125 125 125 125 125 125 126 93 106 106 106 106 106 106 106 93 106 106 106 106 106 106 106 124 125 125 125 125 125 125 125 125 125 125 125 125 125 125 168
93 169 169 169 169 170 145 145 93 145 145 145 145 145 145 145 115 116 116 116 116 116 116 116 116 116 116 116 116 116 116 117 93 145 145 145 145 145 145 145 93 145 145 145 145 145 145 145 115 116 116 128 116 116 142 143 143 143 144 116 128 116 116 117
93 98 98 105 104 106 107 98 93 98 98 98 98 98 98 99 142 143 143 143 143 143 143 143 143 143 143 143 143 143 143 144 93 94 94 94 94 94 94 94 93 94 94 94 94 94 94 94 93 94 94 94 94 94 142 143 143 143 144 94 94 94 171 172
97 108 108 108 105 107 108 108 97 100 108 108 108 108 99 106 124 125 125 125 125 125 125 125 125 125 125 125 125 125 125 126 97 99 100 98 98 98 98 98 109 100 98 98 98 98 99 104 109 98 98 98 98 98 142 143 143 143 144 98 98 98 172 173
109 100 108 108 99 100 108 108 97 106 100 99 100 99 106 106 147 148 148 148 148 149 98 98 98 98 147 148 148 148 148 149 97 106 106 100 99 100 108 108 109 106 100 99 100 99 106 106 97 100 108 108 99 100 142 143 143 143 144 99 100 99 171 174
97 106 100 99 106 106 100 108 109 106 106 106 106 106 106 106 147 148 148 148 148 149 100 108 99 100 147 148 148 148 148 149 97 106 106 106 106 106 115 116 116 116 117 106 106 106 106 106 97 106 100 99 106 106 142 143 143 143 144 106 106 106 172 173
97 106 106 106 106 106 106 100 97 106 106 106 106 106 106 106 147 148 148 148 148 149 120 127 127 121 147 148 148 148 148 149 115 116 116 117 106 106 124 125 125 125 126 106 106 106 106 106 109 123 122 123 123 122 142 143 143 143 144 122 122 123 171 172
97 122 123 123 123 122 123 123 97 123 123 122 123 122 122 123 147 148 148 148 148 149 113 113 113 113 147 148 148 148 148 149 142 143 143 144 106 106 113 113 131 113 113 106 106 106 106 106 97 122 115 117 122 123 142 143 143 143 144 123 123 122 172 173
109 106 101 104 101 101 104 100 97 106 106 101 104 101 101 107 124 125 125 125 125 126 106 106 106 106 124 125 125 125 125 126 124 125 125 126 122 123 123 122 97 122 123 123 122 115 116 117 109 104 142 144 101 104 142 143 143 143 144 104 101 101 171 174
109 106 106 106 106 106 106 106 97 106 106 106 106 106 107 108 131 98 98 98 98 98 105 106 106 106 113 113 113 113 113 113 131 113 113 113 101 101 101 100 109 101 106 106 101 113 113 113 109 106 142 144 106 106 124 125 125 125 126 106 106 107 172 173
97 106 106 106 106 106 106 107 109 106 106 106 106 106 100 108 109 108 108 108 108 108 99 106 107 105 106 106 106 106 106 106 109 106 106 106 106 106 106 106 97 106 106 106 106 106 106 107 109 106 142 144 106 106 113 113 131 98 98 105 107 159 175 176
93 106 106 106 106 106 106 100 93 106 106 106 106 106 106 100 93 108 108 108 108 99 106 107 108 177 105 106 106 106 106 107 93 106 106 106 106 106 106 106 93 106 106 106 106 106 107 108 93 106 142 144 106 178 179 106 93 108 108 108 159 49 180 181
93 123 123 122 123 122 123 123 93 122 123 123 123 122 123 123 93 108 108 108 108 105 107 108 108 108 108 105 122 123 107 108 93 122 122 123 123 122 123 122 93 122 123 123 123 107 108 108 93 122 142 144 122 123 123 122 93 100 108 159 49 49 180 181
115 116 116 128 116 116 116 116 128 116 116 166 167 128 116 117 115 116 116 116 116 116 116 116 116 116 116 116 116 116 116 117 115 116 116 116 116 116 116 116 116 116 116 166 167 116 116 117 115 116 142 144 116 128 141 141 141 141 141 116 116 116 116 117
142 143 143 143 143 143 143 143 143 143 143 143 143 143 143 144 142 143 143 143 143 143 143 143 143 143 143 143 143 143 143 144 142 143 143 143 143 143 143 143 143 143 143 143 143 143 143 144 142 143 143 143 143 143 143 144 143 143 143 143 143 143 143 144
182 183 183 183 183 183 183 183 183 183 183 183 183 183 183 184 182 183 183 183 183 183 183 183 183 183 183 183 183 183 183 184 182 183 183 183 183 183 183 183 183 183 183 183 183 183 183 184 182 183 183 183 183 183 183 184 183 183 183 183 183 183 183 184
59
0 864 656 64 8
0 832 752 32 8
0 944 752 32 8
0 672 848 64 8
0 64 752 32 8
0 176 752 32 8
0 336 416 32 8
1 0 944 16 944
1 1008 944 16 944
1 16 768 48 48
1 80 880 48 32
1 320 944 64 80
1 288 880 32 16
1 512 848 128 16
1 848 880 48 32
1 976 768 32 48
1 960 608 48 16
1 784 608 48 16
1 768 528 24 48
1 792 512 216 32
1 256 800 64 32
1 368 800 32 32
1 432 800 32 32
1 16 480 48 128
1 16 288 16 48
1 32 272 32 32
1 224 400 32 48
1 208 272 32 32
1 416 288 96 176
1 512 160 64 48
1 240 288 176 48
1 256 240 96 128
1 256 368 48 80
1 352 240 64 48
1 416 400 32 48
1 448 368 64 16
1 608 176 80 32
1 800 144 32 96
1 720 128 48 16
1 768 288 240 64
1 864 224 80 128
1 256 720 256 240
1 800 400 32 32
1 880 400 32 32
1 960 400 32 32
1 768 368 240 16
1 208 768 624 48
1 16 48 992 16
1 0 960 1024 16
3 160 848 64 8
3 464 880 32 8
3 928 848 64 8
3 848 592 32 8
3 912 592 32 8
3 352 160 64 8
3 80 352 32 8
3 160 368 64 8
3 64 432 96 8
7 792 528 216 16