16 14
276 277 277 277 277 277 277 277 277 277 277 277 277 277 277 278
231 218 49 49 49 49 49 218 49 49 49 49 49 49 218 229
231 185 49 49 49 49 49 185 190 191 49 49 190 191 185 229
231 189 49 49 190 191 49 189 49 49 191 190 49 49 189 229
231 192 191 190 49 49 191 189 49 49 49 49 49 49 189 229
231 192 49 49 200 201 201 201 201 201 201 202 49 49 192 229
231 192 49 49 229 231 49 218 49 49 229 231 49 49 192 229
231 205 212 206 208 210 49 189 49 49 208 210 205 212 206 229
231 218 49 49 49 49 49 189 49 49 49 49 49 49 218 229
231 192 49 220 221 49 213 189 49 49 49 49 49 49 192 229
231 185 49 222 223 49 191 185 49 49 49 49 49 49 185 229
231 185 195 225 226 207 207 185 207 207 207 207 207 213 185 229
210 200 214 201 201 201 201 201 201 201 201 214 201 201 202 208
229 230 230 230 230 230 230 230 230 230 230 230 230 230 230 231
9
3 192 112 48 8
3 16 112 48 8
1 64 144 32 48
1 96 144 64 16
1 160 144 32 48
1 0 224 16 224
1 240 224 16 224
1 16 32 224 16
1 16 224 224 16