16 14
276 277 277 277 277 277 277 277 277 277 277 277 277 277 277 278
231 49 218 281 281 49 218 281 281 218 49 281 281 218 49 229
231 49 192 282 282 49 189 282 282 189 49 282 282 192 49 229
231 190 189 49 49 49 189 49 49 192 49 49 49 189 49 229
231 207 185 207 207 207 185 207 207 185 207 207 207 185 207 229
231 49 192 215 216 49 192 215 216 192 49 215 216 192 49 229
231 49 192 49 49 49 192 49 49 189 49 49 49 189 49 229
231 195 189 207 207 207 189 207 207 189 207 207 207 189 207 229
231 49 189 49 49 49 192 49 49 189 49 49 49 192 49 229
231 49 185 220 221 49 185 49 49 185 49 49 49 185 49 229
231 187 188 222 223 187 188 207 207 187 188 207 213 187 188 229
231 193 194 225 226 193 194 195 207 193 194 213 49 193 194 229
210 203 204 201 201 203 204 201 201 203 204 201 201 203 204 208
229 230 230 230 230 230 230 230 230 230 230 230 230 230 230 231
