16 14
273 274 274 274 274 274 274 274 274 274 274 274 274 274 274 275
144 131 98 98 98 98 98 131 98 98 98 98 98 98 131 142
144 93 108 108 108 108 108 93 99 100 108 108 99 100 93 142
144 109 108 108 99 100 108 109 106 106 100 99 106 106 109 142
144 97 100 99 106 106 100 109 106 106 106 106 106 106 109 142
144 97 106 106 115 116 116 116 116 116 116 117 106 106 97 142
144 97 106 106 142 144 113 131 113 113 142 144 106 106 97 142
144 120 127 121 124 126 106 109 106 106 124 126 120 127 121 142
144 131 113 113 113 113 106 109 106 106 113 113 113 113 131 142
144 97 106 133 134 106 107 109 106 106 106 106 106 106 97 142
144 93 106 135 136 106 100 93 106 106 106 106 106 106 93 142
144 93 105 139 140 122 123 93 123 122 123 123 122 107 93 142
126 115 128 116 116 116 116 116 116 116 116 128 116 116 117 124
142 143 143 143 143 143 143 143 143 143 143 143 143 143 143 144
9
1 64 144 128 16
1 64 128 32 32
1 160 128 32 32
1 0 224 16 224
1 240 224 16 224
1 16 32 224 16
1 16 224 224 16
3 16 112 48 8
3 192 112 48 8