16 14
86 86 87 86 86 86 87 86 86 86 87 86 86 86 87 86
49 49 49 49 49 49 49 49 49 49 49 49 49 49 49 49
49 49 49 49 49 49 49 49 49 49 49 49 49 49 49 49
49 49 49 49 49 49 49 49 49 49 49 49 49 49 49 49
49 49 49 49 49 88 49 49 49 49 49 49 49 49 49 49
49 49 49 49 49 49 49 49 49 49 49 49 49 49 49 49
49 49 49 89 90 91 49 49 49 49 49 88 49 49 49 49
49 49 49 49 49 49 49 49 49 49 49 49 49 49 49 49
49 88 49 49 49 49 49 49 49 49 49 49 49 49 49 49
49 49 49 49 49 49 49 49 49 49 49 49 49 49 49 49
49 49 49 49 49 49 49 49 49 49 49 49 49 49 49 49
49 49 49 49 49 49 49 49 49 49 49 49 49 49 49 49
92 92 92 92 92 92 92 92 92 92 92 92 92 92 92 92
49 49 49 49 49 49 49 49 49 49 49 49 49 49 49 49
