16 14
262 262 262 262 262 262 262 262 262 262 262 262 262 262 262 263
138 98 131 273 273 113 131 273 273 131 113 273 273 131 113 136
138 108 97 274 274 106 109 274 274 109 106 274 274 97 106 136
138 99 109 106 106 106 109 106 106 97 106 106 106 109 106 136
138 122 93 122 123 123 93 123 122 93 123 123 122 93 122 136
138 104 97 129 130 106 97 129 130 97 104 129 130 97 104 136
138 106 97 113 113 106 97 113 113 109 106 113 113 109 106 136
138 105 109 123 123 123 109 123 123 109 123 122 122 109 123 136
138 108 109 106 104 101 97 104 106 109 106 106 106 97 104 136
138 108 93 264 265 106 93 106 106 93 106 106 106 93 106 136
138 95 96 266 267 95 96 123 123 95 96 123 107 95 96 136
138 102 103 268 269 102 103 105 123 102 103 107 108 102 103 136
126 118 119 116 116 118 119 116 116 118 119 116 116 118 119 124
136 137 137 137 137 137 137 137 137 137 137 137 137 137 137 138
