64 59
173 174 174 174 174 174 174 174 173 174 174 174 174 174 174 174 173 174 174 174 175 176 175 176 173 174 174 174 174 174 174 174 173 174 174 174 174 174 174 174 173 174 174 174 174 174 174 174 173 174 174 174 174 174 174 174 173 174 174 174 174 174 174 174
177 49 49 49 49 178 179 49 180 179 49 49 49 49 178 49 180 49 49 49 181 182 181 182 180 179 49 49 178 179 178 49 180 49 49 49 183 49 49 178 180 179 49 49 49 49 178 49 180 49 49 49 49 178 179 49 180 179 49 49 49 49 178 49
180 179 49 49 178 49 49 179 177 49 179 178 179 178 49 49 177 80 49 49 184 185 184 185 177 49 179 178 49 49 49 49 177 179 49 49 178 49 178 49 186 49 179 178 179 178 49 49 180 179 49 49 178 49 49 179 177 49 179 178 179 178 49 49
177 49 179 178 49 49 49 49 177 49 49 49 49 49 49 49 177 49 179 178 181 182 181 182 177 49 49 49 49 49 49 49 177 49 179 178 49 49 187 49 180 49 49 49 49 49 49 49 177 49 179 178 49 49 49 49 177 49 49 49 49 49 49 49
177 49 49 49 49 188 189 190 177 49 49 49 49 49 49 49 177 49 188 189 191 192 191 192 180 49 49 49 49 193 194 49 180 49 49 49 49 49 49 179 177 49 49 49 49 49 49 49 177 49 49 49 49 188 189 190 177 49 49 49 49 49 49 49
177 195 195 195 195 196 197 198 180 195 195 195 195 195 195 195 180 49 49 49 49 49 49 49 180 49 49 49 49 49 49 49 180 195 195 195 195 195 195 195 180 195 195 195 195 195 195 195 177 195 195 195 195 196 197 198 180 195 195 195 195 195 195 199
180 49 49 49 49 179 49 49 180 49 193 200 200 194 49 201 180 195 195 195 195 195 195 195 180 195 195 195 195 195 195 195 188 202 189 189 190 189 189 190 180 49 203 204 203 204 49 201 180 49 49 49 49 179 49 49 180 49 193 200 200 194 49 205
180 49 49 49 49 49 179 178 180 49 49 49 49 49 201 49 177 49 49 49 49 49 49 49 177 49 49 49 49 49 201 49 206 49 49 49 49 49 49 49 180 49 49 49 49 49 201 49 180 49 49 49 49 49 179 178 180 49 49 49 49 49 201 49
177 49 49 49 49 49 49 201 180 49 49 49 49 49 207 49 177 49 49 49 49 49 49 49 177 49 49 49 49 49 179 49 177 49 49 208 209 49 49 201 180 49 49 49 49 49 179 49 177 49 49 49 49 49 49 201 180 49 49 49 49 49 179 49
173 49 49 49 49 49 49 179 177 49 49 49 49 49 49 179 175 176 175 176 49 49 49 175 176 49 49 175 176 49 49 179 173 49 49 210 211 49 49 179 173 49 49 49 49 49 49 179 173 49 49 49 49 49 49 179 177 49 49 49 49 49 49 179
173 195 195 195 195 195 195 195 180 195 195 195 195 195 212 49 181 182 181 182 195 195 195 181 182 195 195 181 182 195 195 195 173 195 195 213 214 195 195 195 173 195 195 195 195 195 195 195 173 195 195 195 195 195 195 195 180 195 195 195 195 195 195 199
188 202 189 190 49 49 49 49 180 49 49 49 49 188 190 190 215 192 191 192 189 189 189 191 192 189 189 191 192 189 189 190 188 189 216 189 189 216 189 189 202 189 189 189 202 189 189 190 188 202 189 190 49 49 49 49 180 49 49 49 49 188 202 190
217 218 218 219 203 204 49 49 173 49 49 203 204 217 218 219 217 218 218 218 218 218 218 218 218 218 218 218 218 218 218 219 217 218 218 218 218 218 218 218 218 218 218 218 218 218 218 219 217 218 218 219 203 204 49 49 173 49 49 203 204 217 218 219
196 197 197 198 49 49 49 49 173 49 49 49 49 196 197 198 196 197 197 197 197 197 197 197 197 197 197 197 197 197 197 198 196 197 197 197 197 197 197 197 197 197 197 197 197 197 197 198 196 197 197 198 49 49 49 49 173 49 49 49 49 196 197 198
173 220 220 220 220 220 220 220 173 220 220 220 220 220 220 220 221 189 189 189 189 189 189 189 189 189 189 189 189 202 189 222 223 220 220 220 220 220 220 220 173 220 220 220 220 220 220 220 173 220 220 220 220 220 220 220 173 220 220 220 220 220 220 220
173 174 174 174 174 174 174 174 173 174 174 174 174 174 174 174 224 218 218 218 218 218 218 218 218 218 218 218 218 218 218 225 173 174 174 174 174 174 174 174 173 174 174 174 174 174 174 174 173 174 174 174 174 174 174 174 173 174 174 174 174 174 174 174
180 49 49 49 49 49 49 49 180 179 49 49 49 49 178 49 226 227 227 227 227 227 227 227 227 227 227 227 227 227 227 228 180 49 49 49 49 49 49 49 180 179 49 49 49 49 178 49 180 178 179 49 49 49 49 49 180 179 49 49 49 49 178 49
180 179 49 49 178 179 49 49 180 49 179 178 179 178 49 49 226 227 227 227 227 227 227 227 227 227 227 227 227 227 227 228 180 179 49 49 178 179 49 49 180 49 179 178 179 178 49 49 177 49 49 179 178 179 49 49 177 49 179 178 179 178 49 49
177 49 179 178 49 49 179 49 177 49 49 49 49 49 49 49 217 218 218 218 218 218 218 218 218 218 218 218 218 218 218 219 177 49 179 178 49 49 179 49 177 49 49 49 49 49 49 49 177 49 49 49 49 49 203 204 203 204 49 49 49 49 49 49
177 49 49 49 49 49 49 179 180 49 49 49 49 49 49 49 226 227 227 227 227 227 227 227 227 227 227 227 227 227 227 228 177 49 49 49 49 49 49 179 180 49 49 49 49 49 49 49 180 49 49 49 49 49 49 49 49 49 49 49 49 49 49 49
177 195 195 195 195 195 195 195 180 195 195 195 195 195 195 195 226 227 227 227 227 227 227 227 227 227 227 227 227 227 227 228 177 195 195 195 195 195 195 195 180 195 195 195 195 195 195 195 180 195 195 195 195 195 195 195 177 195 195 195 195 195 195 199
180 49 49 49 49 49 49 179 180 49 49 49 49 49 49 201 226 227 227 227 227 227 227 227 227 227 227 227 227 227 227 228 180 49 49 49 49 49 49 179 180 49 49 49 49 49 49 201 180 229 230 231 49 49 49 179 177 49 49 49 229 230 231 49
180 49 49 49 49 49 49 49 180 49 49 49 49 49 201 49 226 227 227 227 227 227 227 227 227 227 227 227 227 227 227 228 180 49 49 49 49 49 49 49 180 49 49 49 49 49 201 49 180 49 49 49 49 193 194 49 177 193 194 49 49 49 49 49
177 49 49 49 49 49 49 201 177 49 49 49 49 49 179 49 226 227 227 227 227 227 227 227 227 227 227 227 227 227 227 228 177 49 49 49 49 49 49 49 177 49 49 49 49 49 179 49 177 49 49 49 49 49 49 49 180 49 49 49 49 49 49 49
180 49 49 49 49 49 49 179 177 49 49 49 49 49 49 179 217 218 218 218 218 218 218 218 218 218 218 218 218 218 218 219 180 49 49 49 49 49 49 232 177 49 49 49 49 49 49 179 173 49 49 49 49 49 49 49 177 49 49 49 49 49 49 49
180 195 195 195 195 195 195 195 180 195 195 195 195 195 195 195 226 227 227 227 227 227 227 227 227 227 227 227 227 227 227 228 180 195 195 195 195 195 195 49 233 49 195 195 195 195 195 195 173 195 195 195 195 195 195 195 173 195 195 195 195 195 195 199
177 178 49 49 49 49 49 49 180 49 49 49 49 49 49 179 226 227 227 227 227 227 227 227 227 227 227 227 227 227 227 228 177 178 49 49 49 49 49 49 233 49 49 49 49 49 49 179 188 234 235 235 235 235 235 235 235 235 235 235 235 235 236 190
173 49 49 49 49 49 49 49 173 49 49 49 49 49 49 49 226 227 227 227 227 227 227 227 227 227 227 227 227 227 227 228 173 49 49 49 49 49 49 49 173 49 49 49 49 49 49 49 217 218 218 218 219 218 218 218 218 217 218 218 218 218 218 219
173 49 49 49 49 49 49 49 173 49 49 49 49 49 49 49 196 197 197 197 197 197 197 197 197 197 197 197 197 197 197 198 173 49 49 49 49 49 49 49 173 49 49 49 49 49 49 49 196 197 197 197 198 197 197 197 197 196 197 197 197 197 197 198
188 189 189 202 220 220 220 220 173 220 220 220 220 220 220 220 173 220 220 220 220 220 220 220 173 220 220 220 220 220 220 220 173 220 220 220 220 220 220 220 173 220 220 220 220 220 220 220 173 220 220 220 220 220 220 220 173 220 220 220 220 220 220 220
217 218 218 219 174 174 174 174 173 174 174 174 174 174 174 174 173 174 174 174 174 174 174 174 173 174 174 174 174 174 174 174 173 174 174 174 174 174 174 174 173 174 174 174 174 174 174 174 173 174 174 174 174 174 174 174 173 174 174 174 174 174 174 174
226 227 227 228 49 49 49 49 180 179 49 49 49 183 49 49 180 49 49 49 49 49 49 49 180 179 49 49 49 49 178 49 180 49 49 49 49 49 49 49 180 179 49 49 49 49 178 49 180 49 49 49 49 49 49 49 180 49 178 179 49 49 178 49
226 227 227 228 193 200 200 200 200 194 179 178 179 178 49 49 177 179 49 49 178 179 49 178 177 49 179 178 179 178 49 49 180 179 49 49 178 179 49 49 180 49 179 178 179 178 49 49 177 179 49 49 178 179 49 49 177 178 49 49 179 178 49 49
217 218 218 219 49 49 49 49 206 49 49 49 49 49 49 49 177 49 179 178 49 203 204 49 177 49 49 49 49 49 49 49 177 49 179 178 49 49 179 49 180 49 49 49 49 49 49 49 177 49 179 178 49 49 179 178 177 49 49 49 49 49 49 49
226 227 227 228 49 49 49 201 180 49 49 49 49 49 188 190 180 49 49 49 49 49 49 49 180 195 188 190 195 195 195 195 177 49 49 49 49 49 49 179 233 49 49 49 49 49 49 49 177 195 188 190 195 195 195 188 190 195 195 195 188 190 195 199
226 227 227 228 195 195 201 49 180 195 195 195 195 195 217 219 173 49 49 49 49 49 49 49 177 49 217 219 49 49 49 49 177 195 195 195 195 195 195 195 180 195 195 195 195 195 195 195 180 49 217 219 49 49 49 217 219 49 49 49 217 219 49 49
196 197 197 198 49 49 49 49 180 49 193 200 200 194 196 198 188 189 190 195 195 195 195 195 177 195 196 197 188 189 189 190 180 49 49 49 49 49 49 179 180 49 49 49 49 49 49 201 188 202 196 198 188 189 190 196 198 188 189 190 196 198 189 190
206 49 49 49 49 193 194 49 177 49 49 49 49 49 49 49 217 218 219 49 49 49 49 201 180 49 49 49 49 49 49 49 180 49 49 49 49 49 49 49 180 49 49 49 49 49 201 49 206 49 49 49 49 49 49 49 206 49 49 49 49 49 49 49
180 49 49 49 49 49 49 201 177 49 49 49 49 49 49 201 226 227 228 195 201 183 201 49 177 183 195 195 237 49 238 195 177 49 49 49 49 49 49 201 177 49 49 49 49 49 179 49 177 49 49 208 209 49 49 201 177 183 201 183 49 49 49 49
177 49 49 49 49 49 49 179 180 49 49 49 49 49 201 49 226 227 228 201 49 49 49 49 177 178 49 49 49 49 49 201 180 49 49 49 49 49 49 179 177 49 49 49 49 49 49 179 173 49 49 210 211 49 49 179 173 49 49 49 183 49 49 49
180 195 195 195 195 195 195 195 180 195 195 195 195 201 49 49 226 227 228 49 49 49 49 49 173 195 195 195 195 195 201 49 180 195 195 195 195 195 195 195 180 195 195 195 195 195 195 195 173 195 195 213 214 195 195 195 173 49 49 49 49 183 195 199
188 190 49 49 49 49 49 49 177 49 49 49 49 49 49 188 226 227 228 188 189 202 189 239 240 189 202 189 189 239 240 190 177 178 49 49 49 49 49 49 180 49 49 49 49 49 49 179 188 189 216 189 189 216 189 189 202 189 189 189 189 202 189 190
217 218 188 190 49 49 49 49 173 49 49 49 49 188 190 219 217 218 218 218 218 218 218 218 218 218 218 218 218 218 218 219 173 49 49 49 49 49 49 49 173 49 49 49 49 49 49 49 217 218 218 218 218 218 218 218 218 218 218 218 218 218 218 219
196 197 197 198 49 49 49 49 173 49 49 49 49 196 197 198 196 197 197 197 197 197 197 197 197 197 197 197 197 197 197 198 173 49 49 49 49 49 49 49 173 49 49 49 49 49 49 49 196 197 197 197 197 197 197 197 197 197 197 197 197 197 197 241
173 220 220 220 220 220 220 220 173 220 220 220 220 220 220 220 188 189 189 189 189 189 189 189 189 189 189 189 189 189 189 190 173 220 220 220 220 220 220 220 173 220 220 220 220 220 220 220 188 189 189 202 189 189 242 243 243 243 244 189 202 189 189 190
173 49 49 183 49 49 201 49 173 49 49 49 49 49 49 178 217 218 218 218 218 218 218 218 218 218 218 218 218 218 218 219 173 174 174 174 174 174 174 174 173 174 174 174 174 174 174 174 173 174 174 174 174 174 217 218 218 218 219 174 174 174 245 246
180 49 49 49 183 201 49 49 180 179 49 49 49 49 178 49 196 197 197 197 197 197 197 197 197 197 197 197 197 197 197 198 180 178 179 49 49 49 49 49 177 179 49 49 49 49 178 49 177 49 49 49 49 49 217 218 218 218 219 49 49 49 247 248
177 179 49 49 178 179 49 49 180 49 179 178 179 178 49 49 226 227 227 227 227 228 49 49 49 49 226 227 227 227 227 228 180 49 49 179 178 179 49 49 177 49 179 178 179 178 49 49 180 179 49 49 178 179 217 218 218 218 219 178 179 178 245 249
180 49 179 178 49 49 179 49 177 49 49 49 49 49 49 49 226 227 227 227 227 228 179 49 178 179 226 227 227 227 227 228 180 49 49 49 49 49 188 189 189 189 190 49 49 49 49 49 180 49 179 178 49 49 217 218 218 218 219 49 49 49 247 248
180 49 49 49 49 49 49 179 180 49 49 49 49 49 49 49 226 227 227 227 227 228 193 200 200 194 226 227 227 227 227 228 188 189 189 190 49 49 196 197 197 197 198 49 49 49 49 49 177 195 195 195 195 195 217 218 218 218 219 195 195 195 245 246
180 195 195 195 195 195 195 195 180 195 195 195 195 195 195 195 226 227 227 227 227 228 49 49 49 49 226 227 227 227 227 228 217 218 218 219 49 49 49 49 206 49 49 49 49 49 49 49 180 195 188 190 195 195 217 218 218 218 219 195 195 195 247 248
177 49 49 49 49 49 49 179 180 49 49 49 49 49 49 201 196 197 197 197 197 198 49 49 49 49 196 197 197 197 197 198 196 197 197 198 195 195 195 195 180 195 195 195 195 188 189 190 177 49 217 219 49 49 217 218 218 218 219 49 49 49 245 249
177 49 49 49 49 49 49 49 180 49 49 49 49 49 201 49 206 49 49 49 49 49 183 49 49 49 49 49 49 49 49 49 206 49 49 49 49 49 49 179 177 49 49 49 49 49 49 49 177 49 217 219 49 49 196 197 197 197 198 49 49 201 247 248
180 49 49 49 49 49 49 201 177 49 49 49 49 49 179 49 177 49 49 49 49 49 178 49 201 183 49 49 49 49 49 49 177 49 49 49 49 49 49 49 180 49 49 49 49 49 49 201 177 49 217 219 49 49 49 49 206 49 49 183 201 49 250 251
173 49 49 49 49 49 49 179 173 49 49 49 49 49 49 179 173 49 49 49 49 178 49 201 49 49 183 49 49 49 49 201 173 49 49 49 49 49 49 49 173 49 49 49 49 49 201 49 173 49 217 219 49 252 253 49 173 49 49 49 49 49 254 255
173 195 195 195 195 195 195 195 173 195 195 195 195 195 195 195 173 49 49 49 49 183 201 49 49 49 49 183 195 195 201 49 173 195 195 195 195 195 195 195 173 195 195 195 195 201 49 49 173 195 217 219 195 195 49 195 173 179 49 49 49 49 254 255
188 189 189 202 189 189 189 189 202 189 189 239 240 202 189 190 188 189 189 189 189 189 189 189 189 189 189 189 189 189 189 190 188 189 189 189 189 189 189 189 189 189 189 239 240 189 189 190 188 189 217 219 189 202 216 216 216 216 216 189 189 189 189 190
217 218 218 218 218 218 218 218 218 218 218 218 218 218 218 219 217 218 218 218 218 218 218 218 218 218 218 218 218 218 218 219 217 218 218 218 218 218 218 218 218 218 218 218 218 218 218 219 217 218 218 218 218 218 218 219 218 218 218 218 218 218 218 219
256 257 257 257 257 257 257 257 257 257 257 257 257 257 257 258 259 257 257 257 257 257 257 257 257 257 257 257 257 257 257 258 259 257 257 257 257 257 257 257 257 257 257 257 257 257 257 258 259 257 257 257 257 257 257 260 257 257 257 257 257 257 257 258
