16 14
274 274 274 274 274 274 274 274 274 274 274 274 274 274 274 275
144 98 131 279 279 113 131 279 279 131 113 279 279 131 113 142
144 108 97 280 280 106 109 280 280 109 106 280 280 97 106 142
144 99 109 106 106 106 109 106 106 97 106 106 106 109 106 142
144 122 93 122 123 123 93 123 122 93 123 123 122 93 122 142
144 104 97 129 130 106 97 129 130 97 104 129 130 97 104 142
144 106 97 113 113 106 97 113 113 109 106 113 113 109 106 142
144 105 109 123 123 123 109 123 123 109 123 122 122 109 123 142
144 108 109 106 104 101 97 104 106 109 106 106 106 97 104 142
144 108 93 133 134 106 93 106 106 93 106 106 106 93 106 142
144 95 96 135 136 95 96 123 123 95 96 123 107 95 96 142
144 102 103 139 140 102 103 105 123 102 103 107 108 102 103 142
126 118 119 116 116 118 119 116 116 118 119 116 116 118 119 124
142 143 143 143 143 143 143 143 143 143 143 143 143 143 143 144
