16 14
261 262 262 262 262 262 262 262 262 262 262 262 262 262 262 263
138 131 98 98 98 98 98 131 98 98 98 98 98 98 131 136
138 93 108 108 108 108 108 93 99 100 108 108 99 100 93 136
138 109 108 108 99 100 108 109 106 106 100 99 106 106 109 136
138 97 100 99 106 106 100 109 106 106 106 106 106 106 109 136
138 97 106 106 115 116 116 116 116 116 116 117 106 106 97 136
138 97 106 106 136 138 113 131 113 113 136 138 106 106 97 136
138 120 127 121 124 126 106 109 106 106 124 126 120 127 121 136
138 131 113 113 113 113 106 109 106 106 113 113 113 113 131 136
138 97 106 264 265 106 107 109 106 106 106 106 106 106 97 136
138 93 106 266 267 106 100 93 106 106 106 106 106 106 93 136
138 93 105 268 269 122 123 93 123 122 123 123 122 107 93 136
126 115 128 116 116 116 116 116 116 116 116 128 116 116 117 124
136 137 137 137 137 137 137 137 137 137 137 137 137 137 137 138
