16 14
270 271 271 271 271 271 271 271 271 271 271 271 271 271 271 272
219 206 49 49 49 49 49 206 49 49 49 49 49 49 206 217
219 173 49 49 49 49 49 173 178 179 49 49 178 179 173 217
219 177 49 49 178 179 49 177 49 49 179 178 49 49 177 217
219 180 179 178 49 49 179 177 49 49 49 49 49 49 177 217
219 180 49 49 188 189 189 189 189 189 189 190 49 49 180 217
219 180 49 49 217 219 49 206 49 49 217 219 49 49 180 217
219 193 200 194 196 198 49 177 49 49 196 198 193 200 194 217
219 206 49 49 49 49 49 177 49 49 49 49 49 49 206 217
219 180 49 208 209 49 201 177 49 49 49 49 49 49 180 217
219 173 49 210 211 49 179 173 49 49 49 49 49 49 173 217
219 173 183 213 214 195 195 173 195 195 195 195 195 201 173 217
198 188 202 189 189 189 189 189 189 189 189 202 189 189 190 196
217 218 218 218 218 218 218 218 218 218 218 218 218 218 218 219
