16 14
270 271 271 271 271 271 271 271 271 271 271 271 271 271 271 272
219 49 206 275 275 49 206 275 275 206 49 275 275 206 49 217
219 49 180 276 276 49 177 276 276 177 49 276 276 180 49 217
219 178 177 49 49 49 177 49 49 180 49 49 49 177 49 217
219 195 173 195 195 195 173 195 195 173 195 195 195 173 195 217
219 49 180 203 204 49 180 203 204 180 49 203 204 180 49 217
219 49 180 49 49 49 180 49 49 177 49 49 49 177 49 217
219 183 177 195 195 195 177 195 195 177 195 195 195 177 195 217
219 49 177 49 49 49 180 49 49 177 49 49 49 180 49 217
219 49 173 208 209 49 173 49 49 173 49 49 49 173 49 217
219 175 176 210 211 175 176 195 195 175 176 195 201 175 176 217
219 181 182 213 214 181 182 183 195 181 182 201 49 181 182 217
198 191 192 189 189 191 192 189 189 191 192 189 189 191 192 196
217 218 218 218 218 218 218 218 218 218 218 218 218 218 218 219
