64 59
93 94 94 94 94 94 94 94 93 94 94 94 94 94 94 94 93 94 94 94 95 96 95 96 93 94 94 94 94 94 94 94 93 94 94 94 94 94 94 94 93 94 94 94 94 94 94 94 93 94 94 94 94 94 94 94 93 94 94 94 94 94 94 94
97 98 98 98 98 99 100 98 97 100 98 98 98 98 99 101 97 98 98 98 102 103 102 103 97 100 98 98 99 100 99 104 97 98 98 98 105 106 104 107 97 100 98 98 98 98 99 101 97 98 98 98 98 99 100 98 97 100 98 98 98 98 99 101
97 100 108 108 99 106 106 100 109 106 100 99 100 99 106 106 109 110 108 108 111 112 111 112 109 106 100 99 106 106 106 106 109 100 108 108 99 106 107 108 109 106 100 99 100 99 106 106 97 100 108 108 99 106 106 100 109 106 100 99 100 99 106 106
109 106 100 99 106 106 106 106 109 106 106 106 106 106 106 106 109 113 100 99 102 103 102 103 109 106 106 106 106 106 106 106 109 106 100 99 106 106 114 108 97 106 106 106 106 106 106 106 109 106 100 99 106 106 106 106 109 106 106 106 106 106 106 106
109 106 106 106 106 115 116 117 109 106 106 106 106 106 106 106 109 106 115 116 118 119 118 119 97 106 106 106 106 120 121 106 97 106 106 106 106 106 106 100 109 106 106 106 106 106 106 106 109 106 106 106 106 115 116 117 109 106 106 106 106 106 106 106
109 122 123 122 123 124 125 126 97 122 123 123 123 123 123 122 97 106 113 113 113 113 113 113 97 106 106 106 106 113 113 106 97 122 123 123 123 122 123 123 97 122 123 123 123 123 122 123 109 122 123 122 123 124 125 126 97 122 123 123 123 123 123 122
97 106 101 101 104 100 98 98 97 104 120 127 127 121 101 107 97 122 123 123 123 123 122 123 97 122 123 123 123 122 123 123 115 128 116 116 117 116 116 117 97 104 129 130 129 130 101 107 97 106 101 101 104 100 98 98 97 104 120 127 127 121 101 107
97 106 106 106 106 106 100 99 97 106 113 113 113 113 107 108 109 104 101 101 101 101 104 104 109 101 104 101 101 101 107 108 131 113 113 113 113 113 113 113 97 106 113 113 113 113 107 108 97 106 106 106 106 106 100 99 97 106 113 113 113 113 107 108
109 106 106 106 106 106 106 107 97 106 106 106 106 106 132 108 109 106 106 106 106 106 106 106 109 106 106 106 106 106 100 108 109 106 106 49 49 106 106 107 97 106 106 106 106 106 100 108 109 106 106 106 106 106 106 107 97 106 106 106 106 106 100 108
93 106 106 106 106 106 106 100 109 106 106 106 106 106 106 100 95 96 95 96 106 106 106 95 96 106 106 95 96 106 106 100 93 106 106 49 49 106 106 100 93 106 106 106 106 106 106 100 93 106 106 106 106 106 106 100 109 106 106 106 106 106 106 100
93 122 123 123 123 123 122 123 97 123 123 123 123 123 122 123 102 103 102 103 133 133 122 134 103 122 123 102 103 122 123 123 93 122 123 49 49 123 122 123 93 122 123 122 123 123 122 123 93 122 123 123 123 123 122 123 97 123 123 123 123 123 122 123
115 128 116 117 101 101 106 104 97 101 104 101 106 115 128 117 118 119 118 119 116 116 116 118 119 116 116 118 119 116 116 117 115 116 135 116 116 135 116 116 128 116 116 116 128 116 116 117 115 128 116 117 101 101 106 104 97 101 104 101 106 115 128 117
136 137 137 138 129 130 106 106 93 106 106 129 130 136 137 138 136 137 137 137 137 137 137 137 137 137 137 137 137 137 137 138 136 137 137 137 137 137 137 137 137 137 137 137 137 137 137 138 136 137 137 138 129 130 106 106 93 106 106 129 130 136 137 138
124 125 125 126 113 113 106 106 93 106 106 113 113 124 125 126 124 125 125 125 125 125 125 125 125 125 125 125 125 125 125 126 124 125 125 125 125 125 125 125 125 125 125 125 125 125 125 126 124 125 125 126 113 113 106 106 93 106 106 113 113 124 125 126
93 139 139 139 139 139 139 139 93 139 139 139 139 139 139 139 115 116 116 128 116 116 116 116 128 116 116 116 116 128 116 117 93 139 139 139 139 139 139 139 93 139 139 139 139 139 139 139 93 139 139 139 139 139 139 139 93 139 139 139 139 139 139 139
93 94 94 94 94 94 94 94 93 94 94 94 94 94 94 94 136 137 137 137 137 137 137 137 137 137 137 137 137 137 137 140 93 94 94 94 94 94 94 94 93 94 94 94 94 94 94 94 93 94 94 94 94 94 94 94 93 94 94 94 94 94 94 94
97 98 98 98 98 98 98 98 97 100 98 98 98 98 99 106 141 142 142 142 142 142 142 142 142 142 142 142 142 142 142 143 97 98 98 98 98 98 98 98 97 100 98 98 98 98 99 106 97 99 100 98 98 98 98 98 97 100 98 98 98 98 99 104
97 100 108 108 99 100 108 108 97 106 100 99 100 99 106 106 141 142 142 142 142 142 142 142 142 142 142 142 142 142 142 143 97 100 108 108 99 100 108 108 97 106 100 99 100 99 106 106 109 106 106 100 99 100 108 108 109 106 100 99 100 99 106 106
109 106 100 99 106 106 100 108 109 106 106 106 106 106 106 106 136 137 137 137 137 137 137 137 137 137 137 137 137 137 137 138 109 106 100 99 106 106 100 108 109 106 106 106 106 106 106 106 109 106 106 106 106 106 129 130 129 130 106 106 106 106 106 106
109 106 106 106 106 106 106 100 109 106 106 106 106 106 106 106 141 142 142 142 142 142 142 142 142 142 142 142 142 142 142 143 109 106 106 106 106 106 106 100 97 106 106 106 106 106 106 106 97 106 106 106 106 106 113 113 109 113 106 106 106 106 106 106
109 123 123 123 122 123 123 123 144 123 123 123 123 123 122 123 141 142 142 142 142 142 142 142 142 142 142 142 142 142 142 143 109 123 123 123 122 123 123 123 97 123 123 123 123 123 122 123 97 122 123 123 122 123 122 123 109 122 122 123 123 122 123 122
97 106 101 101 106 106 101 100 97 106 101 104 106 101 106 107 141 142 142 142 142 142 142 142 142 142 142 142 142 142 142 143 97 106 101 101 106 106 101 100 97 106 101 104 106 101 106 107 97 145 146 147 101 104 101 100 109 104 101 104 145 146 147 101
97 106 106 106 106 106 106 106 97 106 106 106 106 106 107 108 141 142 142 142 142 142 142 142 142 142 142 142 142 142 142 143 97 106 106 106 106 106 106 106 97 106 106 106 106 106 107 108 97 113 113 113 106 120 121 106 109 120 121 106 113 113 113 106
109 106 106 106 106 106 106 107 109 106 106 106 106 106 100 108 141 142 142 142 142 142 142 142 142 142 142 142 142 142 142 143 109 106 106 106 106 106 106 107 109 106 106 106 106 106 100 108 109 106 106 106 106 113 113 106 97 113 113 106 106 106 106 106
97 106 106 106 106 106 106 100 109 106 106 106 106 106 106 100 136 137 137 137 137 137 137 137 137 137 137 137 137 137 137 138 97 106 106 106 106 106 106 100 109 106 106 106 106 106 106 100 93 106 106 106 106 106 106 106 109 106 106 106 106 106 106 106
97 122 123 123 123 122 123 123 97 123 123 123 123 122 123 123 141 142 142 142 142 142 142 142 142 142 142 142 142 142 142 143 97 122 123 123 123 122 123 123 97 123 123 123 123 122 123 123 93 123 123 123 123 123 123 123 93 123 123 123 123 123 123 122
109 99 101 106 104 106 106 106 97 104 101 106 106 106 106 100 141 142 142 142 142 142 142 142 142 142 142 142 142 142 142 143 109 99 101 106 104 106 106 106 148 149 101 106 106 106 106 100 115 150 151 151 151 151 151 151 151 151 151 151 151 151 152 117
93 106 106 106 106 106 106 106 93 106 106 106 106 106 106 106 141 142 142 142 142 142 142 142 142 142 142 142 142 142 142 143 93 106 106 106 106 106 106 106 93 106 106 106 106 106 106 106 136 137 137 137 138 137 137 137 137 136 137 137 137 137 137 138
93 106 106 106 106 106 106 106 93 106 106 106 106 106 106 106 124 125 125 125 125 125 125 125 125 125 125 125 125 125 125 126 93 106 106 106 106 106 106 106 93 106 106 106 106 106 106 106 124 125 125 125 126 125 125 125 125 124 125 125 125 125 125 126
115 116 116 128 139 139 139 139 93 139 139 139 139 139 139 139 93 139 139 139 139 139 139 139 93 139 139 139 139 139 139 139 93 139 139 139 139 139 139 139 93 139 139 139 139 139 139 139 93 139 139 139 139 139 139 139 93 139 139 139 139 139 139 139
136 137 137 138 94 94 94 94 93 94 94 94 94 94 94 94 93 94 94 94 94 94 94 94 93 94 94 94 94 94 94 94 93 94 94 94 94 94 94 94 93 94 94 94 94 94 94 94 93 94 94 94 94 94 94 94 93 94 94 94 94 94 94 94
141 142 142 143 98 98 98 98 97 100 98 98 98 105 106 104 97 98 98 98 98 98 98 98 97 100 98 98 98 98 99 106 97 98 98 98 98 98 98 98 97 100 98 98 98 98 99 106 97 98 98 98 98 98 98 98 97 98 99 100 98 98 99 104
141 142 142 143 120 127 127 127 127 121 100 99 100 99 106 106 109 100 108 108 99 100 108 99 109 106 100 99 100 99 106 106 97 100 108 108 99 100 108 108 97 106 100 99 100 99 106 106 109 100 108 108 99 100 108 108 109 99 106 106 100 99 106 106
136 137 137 138 113 113 113 113 131 113 106 106 106 106 106 106 109 106 100 99 106 129 130 106 109 106 106 106 106 106 106 106 109 106 100 99 106 106 100 108 97 106 106 106 106 106 106 106 109 106 100 99 106 106 100 99 109 106 106 106 106 106 106 106
141 142 142 143 106 106 106 107 97 106 106 106 106 106 115 117 97 106 106 106 106 113 113 106 97 123 115 117 122 123 123 123 109 106 106 106 106 106 106 100 97 106 106 106 106 106 106 106 109 122 115 117 122 123 123 115 117 122 123 122 115 117 122 123
141 142 142 143 122 123 107 108 97 122 123 122 123 122 136 138 93 104 101 104 101 101 104 101 109 104 136 138 101 104 104 101 109 123 123 123 122 123 123 123 97 123 123 123 123 123 122 123 97 101 136 138 104 101 104 136 138 101 104 101 136 138 101 104
124 125 125 126 104 106 101 104 97 104 120 127 127 121 124 126 115 116 117 122 122 122 122 122 109 122 124 125 115 116 116 117 97 106 101 101 106 106 101 100 97 106 101 104 106 101 106 107 115 128 124 126 115 116 117 124 126 115 116 117 124 126 116 117
131 113 113 113 106 120 121 106 109 106 113 113 113 113 113 113 136 137 138 101 104 101 104 107 97 101 113 113 113 113 113 113 97 106 106 106 106 106 106 106 97 106 106 106 106 106 107 108 131 113 113 113 113 113 113 113 131 113 113 113 113 113 113 113
97 106 106 106 106 113 113 107 109 106 106 106 106 106 106 107 141 142 143 122 107 105 107 153 109 105 122 122 123 122 123 122 109 106 106 106 106 106 106 107 109 106 106 106 106 106 100 108 109 106 106 49 49 106 106 107 109 105 107 105 106 106 106 106
109 106 106 106 106 106 106 100 97 106 106 106 106 106 107 108 141 142 143 107 108 108 153 49 109 99 101 104 106 106 101 107 97 106 106 106 106 106 106 100 109 106 106 106 106 106 106 100 93 106 106 49 49 106 106 100 93 108 108 108 105 106 106 106
97 122 123 123 122 122 123 123 97 122 122 123 122 107 108 108 141 142 143 108 108 153 49 49 93 122 123 122 122 122 107 153 97 122 123 123 123 122 123 123 97 123 123 123 123 122 123 123 93 122 123 49 49 123 122 123 93 108 108 108 108 105 123 122
115 117 104 101 104 101 106 104 109 104 101 106 104 101 104 115 141 142 143 115 116 128 116 154 155 116 128 116 116 154 155 117 109 99 101 106 104 106 106 106 97 104 101 106 106 106 106 100 115 116 135 116 116 135 116 116 128 116 116 116 116 128 116 117
136 137 115 117 106 106 106 106 93 106 106 106 106 115 117 138 136 137 137 137 137 137 137 137 137 137 137 137 137 137 137 138 93 106 106 106 106 106 106 106 93 106 106 106 106 106 106 106 136 137 137 137 137 137 137 137 137 137 137 137 137 137 137 138
124 125 125 126 106 106 106 106 93 106 106 106 106 124 125 126 124 125 125 125 125 125 125 125 125 125 125 125 125 125 125 126 93 106 106 106 106 106 106 106 93 106 106 106 106 106 106 106 124 125 125 125 125 125 125 125 125 125 125 125 125 125 125 156
93 157 157 157 157 158 139 139 93 139 139 139 139 139 139 139 115 116 116 116 116 116 116 116 116 116 116 116 116 116 116 117 93 139 139 139 139 139 139 139 93 139 139 139 139 139 139 139 115 116 116 128 116 116 136 137 137 137 138 116 128 116 116 117
93 98 98 105 104 106 107 98 93 98 98 98 98 98 98 99 136 137 137 137 137 137 137 137 137 137 137 137 137 137 137 138 93 94 94 94 94 94 94 94 93 94 94 94 94 94 94 94 93 94 94 94 94 94 136 137 137 137 138 94 94 94 159 160
97 108 108 108 105 107 108 108 97 100 108 108 108 108 99 106 124 125 125 125 125 125 125 125 125 125 125 125 125 125 125 126 97 99 100 98 98 98 98 98 109 100 98 98 98 98 99 104 109 98 98 98 98 98 136 137 137 137 138 98 98 98 160 161
109 100 108 108 99 100 108 108 97 106 100 99 100 99 106 106 141 142 142 142 142 143 98 98 98 98 141 142 142 142 142 143 97 106 106 100 99 100 108 108 109 106 100 99 100 99 106 106 97 100 108 108 99 100 136 137 137 137 138 99 100 99 159 162
97 106 100 99 106 106 100 108 109 106 106 106 106 106 106 106 141 142 142 142 142 143 100 108 99 100 141 142 142 142 142 143 97 106 106 106 106 106 115 116 116 116 117 106 106 106 106 106 97 106 100 99 106 106 136 137 137 137 138 106 106 106 160 161
97 106 106 106 106 106 106 100 97 106 106 106 106 106 106 106 141 142 142 142 142 143 120 127 127 121 141 142 142 142 142 143 115 116 116 117 106 106 124 125 125 125 126 106 106 106 106 106 109 123 122 123 123 122 136 137 137 137 138 122 122 123 159 160
97 122 123 123 123 122 123 123 97 123 123 122 123 122 122 123 141 142 142 142 142 143 113 113 113 113 141 142 142 142 142 143 136 137 137 138 106 106 113 113 131 113 113 106 106 106 106 106 97 122 115 117 122 123 136 137 137 137 138 123 123 122 160 161
109 106 101 104 101 101 104 100 97 106 106 101 104 101 101 107 124 125 125 125 125 126 106 106 106 106 124 125 125 125 125 126 124 125 125 126 122 123 123 122 97 122 123 123 122 115 116 117 109 104 136 138 101 104 136 137 137 137 138 104 101 101 159 162
109 106 106 106 106 106 106 106 97 106 106 106 106 106 107 108 131 98 98 98 98 98 105 106 106 106 113 113 113 113 113 113 131 113 113 113 101 101 101 100 109 101 106 106 101 113 113 113 109 106 136 138 106 106 124 125 125 125 126 106 106 107 160 161
97 106 106 106 106 106 106 107 109 106 106 106 106 106 100 108 109 108 108 108 108 108 99 106 107 105 106 106 106 106 106 106 109 106 106 106 106 106 106 106 97 106 106 106 106 106 106 107 109 106 136 138 106 106 113 113 131 98 98 105 107 153 163 164
93 106 106 106 106 106 106 100 93 106 106 106 106 106 106 100 93 108 108 108 108 99 106 107 108 165 105 106 106 106 106 107 93 106 106 106 106 106 106 106 93 106 106 106 106 106 107 108 93 106 136 138 106 166 167 106 93 108 108 108 153 49 168 169
93 123 123 122 123 122 123 123 93 122 123 123 123 122 123 123 93 108 108 108 108 105 107 108 108 108 108 105 122 123 107 108 93 122 122 123 123 122 123 122 93 122 123 123 123 107 108 108 93 122 136 138 122 123 123 122 93 100 108 153 49 49 168 169
115 116 116 128 116 116 116 116 128 116 116 154 155 128 116 117 115 116 116 116 116 116 116 116 116 116 116 116 116 116 116 117 115 116 116 116 116 116 116 116 116 116 116 154 155 116 116 117 115 116 136 138 116 128 135 135 135 135 135 116 116 116 116 117
136 137 137 137 137 137 137 137 137 137 137 137 137 137 137 138 136 137 137 137 137 137 137 137 137 137 137 137 137 137 137 138 136 137 137 137 137 137 137 137 137 137 137 137 137 137 137 138 136 137 137 137 137 137 137 138 137 137 137 137 137 137 137 138
170 171 171 171 171 171 171 171 171 171 171 171 171 171 171 172 170 171 171 171 171 171 171 171 171 171 171 171 171 171 171 172 170 171 171 171 171 171 171 171 171 171 171 171 171 171 171 172 170 171 171 171 171 171 171 172 171 171 171 171 171 171 171 172
